xxxxxxxxxx
x0000000cx
x00000A00x
x0xxxxxx0x
x000000b0x
x00C00000x
x00000000x
x000xxx00x
x00a00B00x
xxxxxxxxxx