xxxxxxxxxxxxxxxxx
x000000000000000x
x000000000000000x
x000000000000000x
x000000000000000x
x0000000a0000000x
x000000000000000x
x000000000000000x
x000000000000000x
x000000000000000x
x0000000A0000000x
x000000000000000x
x000000000000000x
x000000000000000x
x000000000000000x
xxxxxxxxxxxxxxxxx