xxxxxxxxxxxxxxxxx
x000000000000000x
x000000000000000x
x000000000000000x
x000000000000000x
x000xx00a000xx00x
x0000b0000000000x
x000000000000000x
x000000000000000x
x000000000000000x
x0000000A0000000x
x0000B0000000000x
x000000000000000x
x000000000000000x
x000000000000000x
xxxxxxxxxxxxxxxxx